*.****
*....*
*....*
*....*
*....*
****.*
